uyn-saac-edc - aced
rjw-ache-cpu - ache
dac-hybe-nqc - achy
acr-ekpz-ssf - acre
mei-hmac-req - acre
adi-tkuq-het - adit
bgd-xkad-zer - adze
tto-oaid-egz - aide
toa-idsb-vqz - aids
yrg-aims-hbt - aims
xai-ntgt-sru - aint
sgx-airs-jcj - airs
bgy-evam-irz - amir
cam-okqo-bhd - amok
jpr-biam-psm - amps
ane-wsvq-sjm - anew
ant-eqsg-qyy - ante
bap-secj-mkj - apse
njb-arcs-kmb - arcs
iia-rcsz-bos - arcs
ewv-wqar-csz - arcs
ipd-earm-ywo - army
zmh-gjar-myt - army
kjw-varu-moo - arum
hka-shyd-vud - ashy
maq-asid-ejm - aside
tex-rxat-opg - atop
ato-prko-thf - atop
ssa-uksz-czt - auks
zdq-eowa-vid - avid
quv-avid-zrr - avid
uit-ptda-wed - awed
png-soka-wry - awry
jrw-axes-saj - axes
arv-haxo-neo - axon
ain-hpbb-aby - baby
rnp-bans-ygp - bans
nid-ujdb-ard - bard
hgh-xzba-rei - bare
nii-mbar-kqf - bark
czx-bark-bim - bark
rbo-dyba-shq - bash
bas-kxwd-wmy - bask
cii-psba-thd - bath
mqd-itba-thy - bath
vgt-bays-tou - bays
dqw-cbay-sqk - bays
fkb-eadc-hdj - bead
wvx-wbea-mip - beam
arb-earu-jej - bear
bec-ktim-dps - beck
qqe-spbe-eth - beet
unh-berk-nxf - berk
ber-nseb-jua - bern
vvn-gtbe-rng - bern
bhz-bets-grk - bets
bet-syfx-bqn - bets
xuu-tvnb-ets - bets
fhb-bevy-rtd - bevy
tbi-bsec-beh - bibs
gva-kvob-ind - bind
nbo-argd-pdg - boar
rbo-dyba-shq - body
mbo-nyso-qda - bony
zpy-boos-rie - boos
bop-sssv-fys - bops
bbo-thsx-swa - both
sun-sbow-sxx - bows
wbo-ysyz-vdh - boys
fgn-vmbr-agk - brag
bra-sifh-wtw - bras
fbu-gsto-eov - bugs
etq-wbuz-zwb - buzz
oib-yesz-uqt - byes
sca-dsna-xuc - cads
cad-sugj-oht - cads
jca-fefn-ayv - cafe
sau-bqca-feo - cafe
ica-neqs-pod - cane
can-erdw-aif - cane
ygi-cani-ngu - caning
gig-ikrc-are - care
pqc-artx-kkn - cart
tks-cast-uuu - cast
rpc-entq-jfi - cent
yce-ssiy-iwh - cess
kzj-bcho-phu - chop
ufc-howv-yuc - chow
cit-yjvw-rbw - city
iec-ngci-tyg - city
jzv-qoco-aty - coat
yif-gcoa-tue - coat
xty-rcoo-koo - cook
rco-optx-xyo - coop
ypu-xoqc-oos - coos
ihk-qwco-rdq - cord
csc-wjco-rek - core
xkx-zcor-kct - cork
pco-tssr-oxi - cots
cou-pnhf-auz - coup
ozw-coup-ncj - coup
tco-upjy-ncy - coup
hev-cove-jkf - cove
fco-vetg-jby - cove
fco-vetg-jby - covet
wec-owsn-yzi - cows
cra-bzxw-ffe - crab
cra-mmdo-fpq - cram
wts-qcre-edo - creed
dxu-crew-ryv - crew
cre-wxev-dmg - crew
msc-ribm-hsk - crib
ocr-opja-rkf - crop
mfu-bgcu-tez - cute
ixg-ncys-tuq - cyst
exs-innc-yst - cyst
xda-doyq-vsw - dado
dad-snuv-qbz - dads
kvd-aftg-uon - daft
dam-pepz-cmc - damp
dam-sype-scn - dams
wbv-dams-hfp - dams
dan-ezik-scj - dane
xzb-dank-ewj - dank
tku-xpjd-ank - dank
abm-dash-kwh - dash
fde-ardc-phx - dear
ipd-earm-ywo - dear
xcg-zdea-ryj - dear
xcg-zdea-ryj - deary
tqz-debt-nby - debt
dee-mjnn-wdu - deem
hsj-udee-pbs - deep
qru-xhbd-eer - deer
zdd-eere-ynf - deer
gsn-kxxd-eft - deft
pdf-ybzd-efy - defy
dem-ousw-fpe - demo
nde-mogr-ooa - demo
siy-ddem-oex - demo
zep-dent-ytg - dent
cbq-xdew-sui - dews
die-snxi-efp - dies
wsd-xsdi-esd - dies
xdi-etzw-wte - diet
gpt-vhmd-ime - dime
hdi-vakq-eoy - diva
iru-gyrd-ocs - docs
ykz-mpdo-doh - dodo
yrf-done-pnx - done
wdo-omch-jmm - doom
pdo-orux-jzr - door
uxc-fnhd-our - dour
ado-vewh-dsp - dove
xri-odoz-eps - doze
erf-yedo-zer - doze
hoy-uuwd-ozy - dozy
gyf-draw-cwe - draw
krd-rayb-gvo - dray
dre-wmox-hsv - drew
ydr-iedd-shs - dried
jdr-opje-yew - drop
duc-hydd-npb - duchy
edu-ckgv-fkg - duck
duc-tspk-myy - duct
duc-tspk-myy - ducts
jzu-hpqd-ues - dues
xap-vdue-sbn - dues
fjy-duff-mbz - duff
mkp-npud-uke - duke
vdm-dyer-gtz - dyer
zgc-adye-rgi - dyer
hnp-hody-ery - dyer
kke-aseo-gbb - ease
ime-asyb-biw - easy
sbe-chox-spe - echo
ont-qued-dyz - eddy
wne-edge-yuc - edge
mee-rgos-dmy - ergo
jre-rgsu-qwn - ergs
cgj-esau-szk - esau
riy-nhpe-spy - espy
yqz-jpae-tch - etch
qet-nacr-wqw - etna
jev-adeu-sxj - evade
aue-odev-erc - ever
ogg-qpze-xpo - expo
yrn-dcey-esm - eyes
xdb-pmfa-ctn - fact
uuf-adep-rvv - fade
wmn-ofed-saf - feds
ozy-feed-dvu - feed
mda-xhfe-esx - fees
iwz-cffe-esz - fees
wzf-erni-dsk - fern
ufi-bssa-jqa - fibs
ifi-bsfg-ssj - fibs
fie-fdgm-moy - fief
fie-fdkm-zoo - fief
bri-figs-woi - figs
cjf-igsu-eef - figs
fir-mfew-ufx - firm
jkz-dtfi-shp - fish
fis-tfuy-udu - fist
wco-bwjf-its - fits
tow-imxf-its - fits
ezf-oamy-oan - foam
ezf-oamy-oan - foamy
xkk-food-ygy - food
rnq-mzef-ops - fops
ofo-refx-dos - fore
for-etxh-ehb - fore
vkd-zufo-rei - fore
yyf-orkn-htk - fork
myz-sfor-mbf - form
rwm-fort-yfw - fort
vzf-ortv-rmh - fort
rwm-fort-yfw - forty
rrc-four-sqa - four
rrc-four-sqa - fours
yjd-tmaf-oxy - foxy
muc-kmef-rom - from
isf-romc-yvw - from
bfu-nkbt-fiw - funk
jfu-ryck-vzy - fury
gai-ndae-nff - gain
okg-amyr-vcg - gamy
rga-udwx-sce - gaud
hfx-kbfg-eek - geek
hze-pzge-rmp - germ
egi-rdxy-gny - gird
ehr-nzgi-rox - giro
bve-fgeg-irt - girt
brg-irta-jhg - girt
ogi-vemw-oen - give
ogo-aduk-rwt - goad
ukx-zngo-adv - goad
aoq-xbgo-erp - goer
cpy-xjgo-ngs - gong
cpy-xjgo-ngs - gongs
ugo-onnm-ecg - goon
adq-igor-eph - gore
edg-oryo-dob - gory
hps-goth-szc - goth
hps-goth-szc - goths
ygr-abhp-nzd - grab
fcf-kfgr-aba - grab
nbv-ptgr-amk - gram
igr-eygn-nsv - grey
jxx-grog-fnb - grog
hpy-zgun-krn - gunk
ggu-nsub-scf - guns
guy-sivc-qqb - guys
hfk-dgym-sbh - gyms
byg-ymsf-sbt - gyms
twh-ackj-cnq - hack
kuv-nwha-hay - haha
ngd-hang-poc - hang
has-pegr-cyt - hasp
rwh-ater-atr - hate
rwh-ater-atr - hater
gha-wksd-kpf - hawk
gha-wksd-kpf - hawks
eeu-miha-zeb - haze
hec-kvpg-xjr - heck
khe-ftbc-fzv - heft
kuo-xbhe-ftn - heft
amh-empd-vqv - hemp
whe-rbiv-fzw - herb
her-bejt-qkq - herb
twu-emhe-rdi - herd
ybx-vjhe-rej - here
vyo-hhig-hmn - high
his-swnh-xag - hiss
cte-hobs-zii - hobs
wkg-enho-bsd - hobs
vho-ckhh-nqz - hock
rwc-qxho-ckm - hock
twt-bdho-neq - hone
hqs-hood-oxb - hood
rhn-oqho-ofb - hoof
pho-seaj-ubw - hose
doh-hubs-fxd - hubs
tic-hues-anh - hues
yhu-ffqe-ugk - huff
vyf-gjhu-ges - huge
hug-ebrw-wbo - huge
ibe-xyob-yfe - ibex
tgr-ibis-oey - ibis
xzp-uxqi-ced - iced
ide-mfzj-yjw - idem
emb-xvhi-mps - imps
iin-kyvn-qjc - inky
dam-miri-spm - iris
kjb-iris-bqu - iris
yph-iron-cbd - iron
pvv-rris-msv - isms
bnb-ewqi-snt - isnt
dtj-absk-osg - jabs
nvj-jamb-fja - jamb
jvi-jams-bmy - jams
jam-sewg-qqr - jams
vtz-jzja-zzx - jazz
bup-wfjj-eep - jeep
jee-rjpm-gad - jeer
swj-estw-pzm - jest
bje-stfm-hgc - jest
hgm-jobs-ykn - jobs
ijo-hnvh-zgp - john
ofx-uzju-dom - judo
yxr-judo-yyj - judo
jum-psyz-pns - jump
jum-psyz-pns - jumps
jun-kvab-fzk - junk
iju-nohx-uqd - juno
vfk-euju-nob - juno
kma-foju-tek - jute
jut-sqgb-rkw - juts
rup-ekju-tsi - juts
zka-bkhk-ids - kids
rki-evzh-hxz - kiev
fnr-ukir-kda - kirk
rsr-kgki-tsp - kits
oxm-aceq-fqq - mace
akd-mags-hgq - mags
pma-gscw-pbb - mags
riz-hmai-nfs - main
dma-kext-nkr - make
wma-nydv-fib - many
kea-mare-thf - mare
psp-mark-hsr - mark
mar-tvhq-pyz - mart
bfm-artz-etq - mart
ama-rybp-axa - mary
cvy-dmat-sca - mats
qma-ttzn-ypz - matt
jrk-zbfm-eek - meek
rmm-eeks-bvn - meek
cme-etyy-yxb - meet
cyy-gqqm-eow - meow
ikq-meow-uhr - meow
kzc-mesh-xcw - mesh
eea-fqmi-cey - mice
jmm-idas-yqv - midas
jsf-midi-njg - midi
kke-vydm-ien - mien
mak-hfnm-ire - mire
qcm-irem-rwu - mire
jso-miss-fxq - miss
txh-hxmi-stc - mist
rpx-ygmi-tek - mite
zct-mite-evq - mite
rek-womo-atr - moat
mob-suhx-orv - mobs
ikf-mode-psy - mode
vgz-vymo-nkj - monk
moo-svjr-ngi - moos
tmo-otiq-bxi - moot
ghm-orec-fpn - more
ake-qfmo-rtj - mort
mos-tdqw-iay - most
muc-kmef-rom - muck
yqq-romu-gso - mugs
pmu-shhk-nxy - mush
xyq-nfmu-skc - musk
ycn-mxna-meb - name
ion-ameg-voq - name
pni-yjon-ato - nato
tts-dcxn-ave - nave
fjb-tnea-rvq - near
hgn-eatd-qvx - neat
bod-neat-qjb - neat
wne-edge-yuc - need
evi-enee-dyb - need
evi-enee-dyb - needy
neo-nvxo-hcx - neon
can-erdw-aif - nerd
dne-rdva-sbd - nerd
ane-wsvq-sjm - news
iec-nibs-qhi - nibs
tjn-ibsn-jso - nibs
bxn-itsz-drt - nits
xyk-jnoo-ntm - noon
nos-ytrh-rcb - nosy
axd-bwno-teh - note
ibn-oteb-znk - note
vui-gnud-eyp - nude
ifo-pqqn-umb - numb
nyo-cwfn-umb - numb
kwb-tnun-sme - nuns
nct-oafs-qen - oafs
yza-szko-ast - oast
toa-thnh-ngo - oath
ooa-tsjg-yyg - oats
aob-oezj-skp - oboe
mtk-ftpo-des - odes
yzz-crqo-nto - onto
vgw-mhno-ozy - oozy
yyd-whwo-urs - ours
rrc-four-sqa - ours
vex-uown-edi - owned
jhj-zown-svt - owns
fij-euox-enw - oxen
zax-hsox-enr - oxen
epa-cehf-tbr - pace
wkp-airo-qjo - pair
hpa-irdr-tfu - pair
ujx-pang-hxn - pang
hhd-pats-fxf - pats
gad-bmpa-wnc - pawn
fpa-ysej-fdy - pays
tpe-asir-kms - peas
pea-sftq-ikd - peas
tvt-rvjp-eat - peat
ppz-peat-zgs - peat
peg-sgqi-wxy - pegs
jie-inwp-ens - pens
upe-rtqc-eay - pert
czh-vpes-twu - pest
dya-qpet-sgd - pets
pew-sjvg-oto - pews
jbj-pier-kqx - pier
acm-pith-ohf - pith
ptb-pits-dqt - pits
ikp-itsk-duz - pits
qcp-opit-ynz - pity
ioy-smwp-ock - pock
jgp-pods-uyt - pods
poe-tqvj-xzk - poet
pbp-xtup-oke - poke
vjw-drfp-ooh - pooh
pqk-rhcp-ooh - pooh
hqp-oren-ufm - pore
ypo-rkgi-vra - pork
rdv-ccmp-osh - posh
pou-nddq-krw - pound
qvp-ourk-wit - pour
rri-yvpr-eps - prep
rri-yvpr-eps - preps
ryp-reyj-jqb - prey
pqx-vtpr-igd - prig
pro-pzcu-ogh - prop
yqh-prop-sny - prop
yqh-prop-sny - props
kev-tpro-wwr - prow
ydn-trtp-uff - puff
knp-umaf-rdx - puma
sqp-umpr-yym - pump
fpu-mphn-att - pump
jpu-psyh-gwh - pups
wxq-mtpy-req - pyre
qua-yvjo-nts - quay
ewb-whrr-acy - racy
ran-iuzd-bjn - rani
tra-pssi-kzv - raps
het-faer-apt - rapt
kra-ysyj-psp - rays
btn-rays-qjo - rays
umy-vuxr-eap - reap
wts-qcre-edo - reed
ref-sajp-upq - refs
ren-txfg-ahx - rent
rri-yvpr-eps - reps
qck-vbre-stt - rest
res-tvkd-xos - rest
ure-stzj-kta - rest
orw-tres-tjy - rest
isi-ribs-gom - ribs
rin-kgto-ddy - rink
war-ipez-thr - ripe
kyi-crip-eoj - ripe
eri-psus-pwk - rips
edj-bkri-tec - rite
kwf-kyer-ite - rite
ufu-gaxr-oad - road
vmr-oanh-jcx - roan
ero-anmq-jrg - roan
wrr-obsr-ieb - robs
bsr-ockd-xsn - rock
srh-cear-ock - rock
dns-nrod-sfi - rods
isv-yuro-esw - roes
csw-oroe-ska - roes
abp-rroo-ftu - roof
jhy-rgro-taw - rota
rub-symk-inm - rubs
xyn-jrug-spt - rugs
rug-susy-ota - rugs
yek-nrui-nps - ruin
uti-hjxr-uin - ruin
cqk-brcr-ump - rump
pdg-rump-bso - rump
rum-pcnn-qai - rump
rus-hcme-hob - rush
vru-thkr-tbi - ruth
fdz-vpru-thd - ruth
oie-tsac-kgr - sack
jfk-wgks-acs - sacs
xpj-tsaf-eyh - safe
wrs-afen-rbk - safe
stq-qfsa-gav - saga
awt-znsa-idh - said
sak-ifzn-dxi - saki
sam-eack-ide - same
qsa-medt-uqj - same
dav-rris-ame - same
oys-amex-dau - same
asa-ndph-kjf - sand
fjc-xfws-ari - sari
nxn-pons-ash - sash
rbc-jsay-sdj - says
zex-scar-fjq - scar
zex-scar-fjq - scarf
tdk-koes-eat - seat
sse-ekmr-hir - seek
cts-erms-eek - seek
nse-ekjb-bhb - seek
see-rjvg-gxi - seer
hud-szse-ess - sees
sen-doko-xch - send
ser-fubc-yyj - serf
ptn-sets-jvb - sets
pnw-uish-ipu - ship
tho-ysho-oou - shoo
hqs-hood-oxb - shoo
csh-otmw-dgw - shot
wub-nsia-mue - siam
maq-asid-ejm - side
ykf-sift-htc - sift
ctx-rfsi-ghe - sigh
vsi-ghje-okw - sigh
ans-ingj-jcv - sing
gsi-nkbb-icg - sink
bsi-psoy-hep - sips
txn-jtsi-rex - sire
hxv-sire-rbx - sire
him-upks-irs - sirs
qac-pysi-tsv - sits
una-wesk-ewy - skew
byt-bmsk-uaz - skua
bxc-eqos-kua - skua
eef-dgsn-agg - snag
bes-noby-qig - snob
yai-snoe-kdz - snoek
adr-xrps-nub - snub
rho-qsnu-gak - snug
iii-soak-bvw - soak
znh-knso-apz - soap
fso-bsad-upb - sobs
kii-eqms-ong - song
tox-mson-gpw - song
svh-souk-pwq - souk
oso-urzg-sup - sour
ojs-owsf-sir - sows
ygx-icos-ows - sows
hfd-zvqs-par - spar
exv-dzgs-pat - spat
uas-pryo-isc - spry
ays-tint-hfy - stint
sto-pbvf-erj - stop
fgi-yvos-tud - stud
fya-pfws-tud - stud
qfs-tunn-sfp - stun
xjw-drst-une - stun
xdc-vdrs-tun - stun
kds-tyxi-unu - styx
vfs-tyxn-qqb - styx
jbs-tyxs-zrh - styx
ggu-nsub-scf - subs
sud-spkq-aqy - suds
jos-umob-amj - sumo
fdg-sunk-smx - sunk
sun-sbow-sxx - suns
bqi-sure-txw - sure
idq-vzrs-urf - surf
yzs-wayg-ugo - sway
cab-vdsw-ede - swede
hkt-kswu-mcf - swum
gfz-gswu-mri - swum
whn-tabs-zbf - tabs
tac-tefk-nvf - tact
tac-trje-tac - tact
tak-etic-bxs - take
tst-amei-djg - tame
dxf-gfta-mpa - tamp
dta-skkg-ewp - task
tvn-wzpt-aut - taut
ofy-gmyt-aut - taut
syp-aote-chj - tech
rxt-edsd-orp - teds
awt-endw-tgw - tend
djb-text-acg - text
tur-than-zki - than
prd-hhtt-haw - thaw
xbe-zftt-hem - them
fma-qath-emj - them
wwt-hemj-udf - them
thi-nhgx-kbm - thin
chf-cstt-hud - thud
mob-pjth-udt - thud
rti-dezs-aev - tide
jqu-tint-jzm - tint
ays-tint-hfy - tint
bnc-whti-nyc - tiny
crp-vdti-roj - tiro
esm-tiro-why - tiro
crj-toby-mmy - toby
rin-kgto-ddy - toddy
aqz-gvyt-oed - toed
bto-esrz-rid - toes
pit-utog-ows - togo
wqs-fqto-nez - tone
ehc-fton-sxq - tons
jay-fton-sbo - tons
qct-onyd-jnh - tony
hzt-ootn-zhe - toot
pmt-otsc-deb - tots
svt-ourg-qeb - tour
ckg-ruto-wsp - tows
sem-btra-mrn - tram
tra-pssi-kzv - trap
tra-pssi-kzv - traps
tro-dqxm-hpe - trod
vor-ojzt-roy - troy
kqp-true-gse - true
eso-oetu-bei - tube
dce-tube-kcg - tube
jsd-btub-eum - tube
oxr-tubs-rdw - tubs
ukc-qfet-una - tuna
dtu-nacu-iry - tuna
xjw-drst-une - tune
tun-sefi-vzf - tuns
kdt-urnh-cmo - turn
twi-nfff-xhz - twin
kwp-smtw-int - twin
ety-pekn-vwa - type
mqs-cwuh-uhq - uhuh
rmh-twun-cut - uncut
wxb-juni-tyv - unit
yya-aheu-nit - unit
wxb-juni-tyv - unity
cus-edfj-nzc - used
vam-phmj-eyg - vamp
uhm-xjdv-ane - vane
wva-stry-pke - vast
dve-ntnr-gfx - vent
ver-bxoj-fcy - verb
tmh-veto-bxe - veto
zvi-msva-vpk - vims
pov-ined-tgh - vine
xkr-gbvi-nok - vino
evi-sauh-aue - visa
vis-anyk-zqh - visa
nro-uywv-ise - vise
mbv-otek-hty - vote
can-erdw-aif - waif
kvi-dwai-tjn - wait
qyu-chmw-ake - wake
pcu-ijjw-and - wand
jhs-wwan-dqt - wand
oxw-arpn-cdz - warp
mkc-chyw-asp - wasp
jao-pgdw-ast - wast
xwa-ttoo-hks - watt
djw-aves-rtf - wave
djw-aves-rtf - waves
xjc-ftwa-vyu - wavy
jrw-axes-saj - waxes
zwe-akux-mqf - weak
wea-rvvn-cje - wear
iqw-edsb-gfh - weds
jwe-ekjt-xoi - week
ewe-enua-khk - ween
grx-yowe-pta - wept
dyw-esto-jmv - west
twh-ackj-cnq - whack
rwh-ater-atr - what
zwh-eydh-erp - whey
wwh-eyvi-nnv - whey
xdt-qwhe-ybg - whey
iwh-imyt-vre - whim
whi-pxde-qqa - whip
wwi-ckgg-rmp - wick
jfy-swif-evp - wife
wim-ppki-hcw - wimp
tnw-indm-kjv - wind
qiy-wine-qtq - wine
kvr-wipe-kuu - wipe
aub-kwbw-ise - wise
uvu-rjwi-shm - wish
vos-woad-uex - woad
sts-wwoe-spi - woes
ahf-onuw-oes - woes
wok-eozi-vmj - woke
iao-wore-few - wore
mbm-gwri-tff - writ
xma-spuw-vxz - xmas
bya-wsph-xrk - yaws
mty-etir-pfm - yeti
syo-girm-ahk - yogi
kgx-bwyo-gic - yogi
yor-kiit-ijs - york
civ-jbyo-urm - your
pyo-yoci-zom - yoyo
ipz-ozze-roh - zero
cut-jaxz-est - zest
uze-stey-fin - zest
iwo-zion-rqp - zion
